"<h2><span style=""font-weight: normal;"">Неконтролируемое машинное обучение</span></h2>"	"<span style=""color: rgb(23, 23, 23);"">Подкласс машинного обучения, в котором нужная модель находит в данных скрытую (латентную) структуру или зависимость.</span>"
"<h2><span style=""font-weight: normal;"">Функция потерь</span></h2>"	<div>Разница между значениями меток обучения и прогноза, сделанного с помощью модели. Оценка параметров модели ведется путем минимизации функции потерь.</div><br>
"<h2><span style=""font-weight: normal;"">Метка</span></h2>"	"<span style=""color: rgb(23, 23, 23);"">Элемент, который прогнозируется с помощью модели машинного обучения. Например, порода собаки или будущая цена акций.</span>"
"<h2><span style=""font-weight: normal;"">Гиперпараметр</span></h2>"	"<span style=""color: rgb(23, 23, 23);"">Параметр алгоритма машинного обучения. В качестве примера можно привести число деревьев, которые изучаются в лесе решений или размер шага в алгоритме градиентного спуска.</span>"
"<h2><span style=""font-weight: normal;"">Двоичная классификация</span></h2>"	"<span style=""color: rgb(23, 23, 23);"">Сценарий классификации,&nbsp;</span><span style=""color: rgb(23, 23, 23);"">в котором значение метки</span><span style=""color: rgb(23, 23, 23);"">&nbsp;может быть только одним из двух классов.&nbsp;</span>"
"<span style=""color: rgb(34, 37, 45);"">shadow DOM</span>"	"<span style=""color: rgb(34, 37, 45);"">теневой DOM, теневая модель документа</span>"
<a>ресурс</a>	<a>составная часть сайта: текстовые файлы, графика, видео, БД и др. В узком смысле «статический ресурс»: стили, скрипты, оформительская графика, в противоположность динамическому содержимому.</a>
<a>Директива</a>	<a>Тип объявления, начинающегося со знака @ (напр. @import).</a>
<a>Mobile first</a>	<a>Подход разработки, при котором проектирование сервиса начинается с мобильной версии, а не с версии для больших экранов.</a>
<a>ppi (pixel per inch)</a>	<a>Пикселей на дюйм, единица измерения плотности пикселей.</a>
Коммутатор	"<span style=""color: rgb(34, 34, 34); background-color: rgb(254, 254, 254);"">Устройство либо программа, осуществляющая выбор одного из возможных вариантов направления передачи данных. Коммутаторы работают на втором уровне контроля доступа к среде модели OSI. В зависимости от назначения различают: магистральные коммутаторы; коммутаторы для рабочих групп; коммутаторы для настольных систем.</span>"
Мост	"<span style=""color: rgb(34, 34, 34); background-color: rgb(254, 254, 254);"">Ретрансляционная система, соединяющая каналы передачи данных. Мост выполняет соединение на канальном уровне модели OSI. Мосты не имеют механизмов управления потоками блоков данных. Различают мосты внутренние и внешние, локальные и удаленные.</span>"
Ретрансляция кадров	"<span style=""color: rgb(34, 34, 34); background-color: rgb(254, 254, 254);"">Высокоскоростная цифровая технология передачи кадров переменной длины, использующая коммутацию кадров и технологию ""точка-точка"", применяющую виртуальный канал для передачи кадров переменной длины на канальном уровне модели OSI.</span>"
Протокол	"<span style=""color: rgb(34, 34, 34); background-color: rgb(254, 254, 254);"">Стандарт, определяющий поведение функциональных блоков при передаче данных. Протокол задается набором правил взаимодействия функциональных блоков, расположенных на одном уровне. Реализуется одной либо группой программ. Описывает: синтаксис сообщения, имена элементов данных, операции управления и состояния</span>"
"Коммуникационный протокол<span style=""color: rgb(34, 34, 34); background-color: rgb(254, 254, 254);"">&nbsp;</span>"	"<span style=""color: rgb(34, 34, 34); background-color: rgb(254, 254, 254);"">Совокупность правил, регламентирующих формат и процедуры обмена информацией между двумя или несколькими независимыми устройствами, компьютерами, программами или процессами.</span>"
"Ретрансляционная система<span style=""color: rgb(34, 34, 34); background-color: rgb(254, 254, 254);"">&nbsp;</span>"	"<span style=""color: rgb(34, 34, 34); background-color: rgb(254, 254, 254);"">Система, предназначенная для передачи данных или преобразования протоколов и осуществляющая коммутацию и маршрутизацию данных согласование протоколов в соединяемых коммуникационных сетях, передачу блоков данных между сетями, укрупнение/разукрупнение блоков данных, управление потоками данных и др. Ретрансляционными системами являются коммутаторы, маршрутизаторы, концентраторы.</span>"
"Протокол маршрутизации<span style=""color: rgb(34, 34, 34); background-color: rgb(254, 254, 254);"">&nbsp;</span>"	<div>Протокол определяющий метод выбора оптимального маршрута для заданных отправителя и получателя; и обеспечивающий правильность доставки сообщений после выбора маршрута.</div><div>Обычно протоколы маршрутизации реализуется через взаимодействие маршрутизаторов.</div>
"Стек протоколов<span style=""color: rgb(34, 34, 34); background-color: rgb(254, 254, 254);"">&nbsp;</span>"	<div>Разделенный на уровни набор протоколов, которые работают совместно, реализуя определенную коммуникационную архитектуру. Обычно задачи того или иного уровня реализуются одним или несколькими протоколами.</div><div>&nbsp;</div>
Коммутируемый доступ	"<span style=""color: rgb(34, 34, 34); background-color: rgb(254, 254, 254);"">Доступ, при котором обеспечивается установление соединений только по необходимости.</span>"
Уровень	"<span style=""color: rgb(34, 34, 34); background-color: rgb(254, 254, 254);"">Набор структур и программ, обеспечивающих обработку определенного класса событий. Уровень выступает единицей декомпозиции совокупности функций, обеспечивающих информационное взаимодействие прикладных процессов.</span>"
<b>OSI</b>	"<span style=""color: rgb(100, 100, 100);"">Это скелет, фундамент и база всех сетевых сущностей. Модель определяет сетевые протоколы, распределяя их на 7 логических уровней. Важно отметить, что в любом процессе, управление сетевой передачей переходит от уровня к уровню, последовательно подключая протоколы на каждом из уровней.</span>"
